66
10
WWWWWWWWWWWWWWWWWWWWWWWWWWWWWWWWWWWWWWWWWWWWWWWWWWWWWWWWWWWWWWWWWW
WPDDDDDDDDDDDDDDDDDDDDDDDDDDDDDDDDDDDDDDDDDDDDDDDDDDDDDDDDDDDDDDDW
WPDWWDDDDWDDDWDDDDDWDDDDWWWWWWDDDWDDDDWWDDDDwDDDWDDDDwDDDDDDDDDDDW
WPDWDWDDDWDDDWDDDDDWDDDDWDDDDWDDDWWDDWDDWDDWWDDDWDDDDWDDDDDDDDDDDW
WPDwDDWDDWDDDWWWWWWWDDDDWDDDDWDDDWDWWDDDDWWDwDDDWWWwWWDDDDDDDDDDDW
WPDwDDDWDWDDDWDDDDDWDDDDWDDDDWDDDWDDDDDDDDDDwDDDDDDDDWDDDDDDDDDDDW
WPDwDDDDWWDDDWDDDDDWDDDDWDDDDWDDDWDDDDDDDDDDwDDDDDDDDWDDDDDDDDDDDW
WPDwDDDDDWDDDWDDDDDWDDDDWWWWWWDDDWDDDDDDDDDDWDDDDDDDDWDDDDDDDDDDDW
WPDDDDDDDDDDDDDDDDDDDDDDDDDDDDDDDDDDDDDDDDDDDDDDDDDDDDDDDDDDDDDDDW
WWWWWWWWWWWWWWWWWWWWWWWWWWWWWWWWWWWWWWWWWWWWWWWWWWWWWWWWWWWWWWWWWW
